"SpurIT": contact@spur-i-t.com
*instinctools: jobs@instinctools.ru
//CODEMASTER: info@codemaster.by
12devs: jobs@12devs.com
1PT: hr@1pt.com
3Seven Studio: 3seven@tut.by
5digital: info@5digital.by
5media: info@5media.by
5NICE: s.lomako@5n.by
69pixels: hello@69pixels.com
7Version: info@7version.com
A-SITE.by: andrey_seo1990@mail.ru
a1qa: job@a1qa.com
Abiatec: info@abiatec.com
ABKonDevelop: info@abkon-develop.by
Acantek Solutions Ltd.: natallia.zhavarankava@acantek.com
ACD/Labs: job_minsk@acdlabs.ru
Acobby Ltd: sergey@acobby.com
ActivePlatform: vera.kudravets@activeplatform.com
Adaptive Studio: info@adaptive.by
Adepta: info@adepta.by
Admitad: a.guliaeva@admitad.com
Aetsoft: o.bozhko@aetsoft.by
Affise: join@affise.com
AGENTE: job@agentestudio.com
Aheadworks: sobolkova@aheadworks.com
Aiolane: info@aiolane.com
AIS Novations: hr@aisnovations.com
Aisconverse: info@aisconverse.com
AKDev Group: s.mehovich@akdev.by
Akvelon: akvelonru@gmail.com
Akveo: hr@akveo.com
Aligned Code: hello@alignedcode.com
Almus: hr.minsk@almusmedia.com
AlphaByte: info@alphabyte.pro
Alseda Consulting: support.banka@alseda.by
Altoros Development: cv@altoros.com
Alverden Systems: info@alverden.com
AMG: job@upsales.ru
Anadea: jobs@anadea.info
Anakreon: info@anakreon.by
Andersen: v.sharnikova@andersenlab.com
Antalika: sales@antalika.com
Anventa Technologies: info@anventa.com
Anveo Ventures: ichukhryaev@anveo.com
Apalon: hr@apalon.com
APoint: info@apoint.by
APOSTROFSOFT: info@apostrofsoft.com
AppAgg: appagg@appagg.com
Applied Systems: info@appsys.net
Appolo: yaroslavna@firebirdtours.com
Appservice: olga.b@upservice.io
Appstud: skvasov@appstud.com
APRO software: info@apro-software.com
ArasCorp Development Center: jobs.by@aras.com
Arateg: ilya.rubl@arateg.by
Arcom Group: support@arcom.group
Arcom Group ltd.: support@arcom.group
Aristek Systems: support@aristeksystems.com
Ariteta: info@ariteta.by
Armada Labs: contact@armadalabs.com
Artcroix: info@artcroix.by
ArtisMedia: info@artismedia.by
ARTOX Lab: e.proshkina@artox.com
ASoft: NOSPAMsergey@asoft.co
ASPsoft.by: hello@ASPsoft.by
Assistent.By: info@assistent.by
AST: AST.vacancy@tut.by
Astronim: info@astronim.com
ASWardag: searsameer@yahoo.com
Atevi Systems: info@atevi.by
ATOMICHRONICA: contact@atomichronica.com
Aurius Studio: info@aurius.by
Avanta: nsmozhevskaya@avanta.co
Aventus IT: hr@aventusgroup.com
Awagro Style: info@awagro.by
Axamit: hr@axamit.com
AXIOMA: info@axioma.lv
AxxonSoft: minsk@axxonsoft.com
Azati: resume@azati.com
BA Solutions: info@basolutions.com
Bamboo Apps: hr@bambooapps.eu
Bamboo Group: contact@bamboogroup.eu
Bank&amp;Soft Innovation: hr@basi.by
Baseline marketing: dasha@bl.agency
BearDev: cv@beardev.com
BeatDev: contact@beatdev.by
BelaBios IOOO: info@belabios.com
BELHARD: info@belhard.com
BelitSoft: hrm@belitsoft.com
BelPrime: jobs@belprime.com
Beltechsoft (Белтехсофт): sales@beltechsoft.com
BelVG: info@belvg.com
BESK: besk_hello@besk.com
Big Data Technologies: hello@bdtech.by
Binitex: ssemeshchenko@binitex.com
bitnet: info@bitnet.by
BKsoft: minsksoftwarejobs@tut.by
Bobaka: info@bobaka.ru
BookYourStudy: rbserg@gmail.com
Bostil Support: office@bostil-support.com
BrainForce: info@brainforce.pro
Brainkeeper: info@brainkeeper.by
Brimit: info@brimit.com
BSL: hr@bsl.dev
BuzzGuru: pavelbeinia@gmail.com
CactusSoft: info@cactussoft.biz
Capsilon: sasha.kosobutsky@capsilon.com
Caspel: info@caspel.by
Cedon BLR: hr@cedoni.com
Centaurea: contact@centaurea.io
CETC: info@cetc.by
ChainArtSoft: pm@chainartsoft.com
CIB software: info@cib.by
Ciklum: minsk@ciklum.com
CleverLabs: ruslan.yemchyk@cleverlabs.io
Clevertec: hr@clevertec.ru
Clickmedia: info@clickmedia.by
CloudCall BY: infoby@cloudcall.com
Cluster Systems: direct@alpsweb.by
Code Inspiration: info@codeinspiration.pro
CodeCave: info@codecave.pro
Coding Staff: support@codingstaff.by
Cogniteq: hr@cogniteq.com
Cognitive Technologies: hr@cognitive.ru
Collab IT: info@collab-it.com
ComplITech: o.semeniuk@complitech.org
Concept Soft: job@concept-soft.com
ConnectOne: mail@connectone.me
Consensuslab: support@coppay.io
CoolHeads Digital: info@coolheads.by
Coral Team: info@coral.team
Corpitech: info@corpitech.by
Cortlex: cv@cortlex.com
Cotvec: hr@cotvec.com
Craft: evgeniya.lubas@craft.co
Crears Systems: info@crears.ru
CreativeIT: hello@creativeit.io
Credentially: igor@drfocused.com
Crossix Solutions: infoby@crossix.veeva.com
CTDEV: jobs@ctdev.by
Cuspy Software: info@cuspy.io
Custodesk: Inbox@it.custodesk.com
Cyberport: office@cyberport.by
Cygno Solutions: ikountsevich@cygno.com
D8 Corporation: d8belarus@d8corp.com
DashBouquet Development: contact@dashbouquet.com
DataMola: info@datamola.com
DataRobot: careers@datarobot.com
datarockets: hello@datarockets.com
Daymare Web Studio: info@daymare.by
Dektry: hello@dektry.com
Delium: Minsk@del.by
Dev Team: apoklyak@dev-team.com
Devicepros: info@devicepros.net
DEVXED: nadias@devxed.com
Digesta Digital: ds@dda.by
Digital Forest: contact@digiforest.io
Digital Top: sales@digital-top.com
Digitalizm: hello@digitalizm.com
DigiTech7: christina.benediktovich@digitech7.by
Digiteum: hello@digiteum.com
Distillery: z.gasanova@distillery.com
Dizzain: hr@dizzain.com
Dream Support: nikita@dreamsupport.io
Dual Lab: ekaterina.bondar@duallab.com
DYNEVO: contact@dynevo.org
DZENSOFT: info@dzensoft.com
EasyProjects.NET: alexandra.nesterova@logicsoftware.net
Efectura: yalkin@efectura.com
EffectiveSoft Ltd.: hrm@effectivesoft.com
Efir Media: info@efirmedia.com
Egorov Agency: welcome@egorovagency.by
Eightydays.me: aleh@ontourcloud.com
EIS Group: minsk@eisgroup.com
ElateSoftware: hr@elatesoftware.com
Elinext: careers@elinext.com
Ellipsoit Plus Ltd: egrudnitskiy.ellipsoit@gmail.com
ElmoSoft: info@elmosoft.net
ELTEAM GROUP: liza.glazina@elteam-group.com
Emerline: info@emerline.com
Enable IT: r.gneiding@enable-it.online
EPAM: info@epam.com
Epicmax: andrei@epicmax.co
Epol Soft: job@epolsoft.com
Espectro: info@espectro.org
ETNA: job-mogilev@etnasoft.com
EVOKE Systems: hr@evoke.by
Evolution Gaming: atarasyuk@evolutiongaming.com
eWave: careers@ewave.com
Exadel: job-minsk@exadel.com
Expert Soft: hcm@expert-soft.by
Exposit: hr@exposit.com
ExtBel: info@extbel.com
Extrit.by: office@extrit.com
Factory 16: info@factory16.by
GERSIS SOFTWARE: info@gersis-software.com
getbob digital agency: contact@getbobagency.com
GICSOFT: i.golovaty@gicsoft-europe.com
Globant: belarus@globant.com
Godel Technologies Europe: job@godeltech.com
GoodSoft: sales@good-soft.com
Goozix: hi@goozix.com
GP Solutions: jobs@gpsolutions.com
Green Moon: info@greenmoon.by
Gresbi: hello@gresbi.com
Grinteq: mika@grinteq.com
GRIZZLY DIGITAL COMPANY: info@grizzly.by
Gusarov Group: info@gusarov.by
HA – Interactive brand studio: info@hainteractive.com
Hackspace: v.barodzich@hackspace.by
HardCode: olga.sbrodava@gmail.com
HardSoft Robotics: hr@hardsoftrobotics.com
Heapix Development: contact@heapix.com
helenova: dev@dev.by
HF-Solution: yuri.gers@hf-solution.com
HiQo Solutions: rabota@hiqo-solutions.com
Humans: team.minsk@humans.net
humansee labs: info@humanseelabs.com
Hytex Solutions Ltd: byqdes@gmail.com
ib.by: koltun@ib.by
IBA Gomel: resume@gomel.iba.by
IBA Group: resume@iba.by
iCode: hr@icode.by
ID Finance: hrminsk@idfinance.com
IdeaSoft: hr@i-deasoft.com
IDT Belarus: minsk-hr@idt.net
iFuture: hr@ifuture.by
IGIES: mailbox@igies.com
Ihighload: info@ihighload.info
IHS Markit: jobminsk@ihsmarkit.com
iKantam: support@ikantam.com
ilavista: mail@ilavista.by
INDI: hello@indi.by
InGrid Lab: devteam@ingridlab.com
inNativeLife / ShaurmaLab: innativelife@gmail.com
InSales: hello@insales.by
intelex: contact@intelex.by
INTELICO: connect@intelico.su
Intellect IT: support@intellectit.by
Intellectsoft: anna.rybchenko@intellectsoft.net
InterDelight: admin@dumki.by
InterTech Solution: info@intertechsolution.com
Intervale: ydeshkovich@intervale.ru
Intetics: job@intetics.com
IntexSoft: job@intexsoft.by
Invatechs Software: info@invatechs.com
IPOS.BY: info@ipos.by
IQClash: hr@iqclash.com
ISsoft: job@issoft.by
IT Band Systems: info@it-band.by
IT Partner: ki@it-partner.ru
it_wave: contact@it-wave.by
ITB / Информационные технологии бизнеса: info@itb.by
iTechArt Group: careers@itechart-group.com
Itexus Soft: jobs@itexus.com
ITHub: hello@ithub.pro
itictory: hr@itictory.com
ITM House: contact@itmhouse.com
ITMEDIA: andrey@itmedia.by
ITOS: info@itosweb.com
itpro: danila@irpro.by
Itransition: hh@itransition.com
ITRex Group: yulia.adamchik@itrexgroup.com
ITS Partner: hr@itspartner.net
ITSupportMe: yshuchalina@itsupportme.com
ITzone: info@itzone.by
Ivelum: job@ivelum.com
JayDevs: yulia.zaitseva@jaydevs.com
Jazz Pixels: info@jazzpixels.com
JETWEB: kaplevsky@gmail.com
Jordan Traffic: hello@jordantraff.com
Just Studio: info@just-studio.by
Kairus: info@thekairus.com
Kakadu Dev: info@kakadu.bz
Kaseya: aleksey.shafransky@kaseya.com
Key Group: ekaterina.h@key-g.com
KeySequences: aleks@keysequences.com
Kibernetiko: hello@kibernetiko.com
Kitkard: kitkardinfo@gmail.com
Klika Tech: info@klika-tech.com
Komspek: alena@komspek.com
Kontur: minsk-jobs@kontur.io
KVITKI BY: info@kvitki.by
Labinvent: info@labinvent.com
Lamanteam: info@lamanteam.by
Lansoft: info@lansoft.by
Lepshey: info@lepshey.ru
LeverX: careers@leverx.com
lifetech: info@lifetech.by
Light Well Organization: kuznetsova_o@lwo.by
Lightpoint Global: hr@lightpointglobal.com
Lime-Express: limexpress.by@gmail.com
LINKOR: hr@link-or.net
Litussoft: info@litussoft.com
LLC AG Software: info@agsoftware.by
LLSOFT: hr@llsoft.by
Logic Way: job@logic-way.com
Lotasoft: info@lotasoft.com
LOVATA: info@lovata.com
Lyte: sasha@lyte.com
MADCODERS: office@madcoders.by
Magedia: contact@magedia.com
Mainsoft: hr@mainsoft.org
Maksis Digital Agency: info@maksis.by
Malanka: i@malanka.pro
Manao: hr@manao-team.com
Manufact: sdt@manufact.pro
Marccoon Digital: info@fullstack.by
Master-M: info@master-m.by
Masterstroke LTD: info.mstroke@gmail.com
Maxbitsolution: t.ventsko@jetmail.cc
MAXI.BY media: media@maxi.by
MBicycle: mbicycle.admin@mbicycle.com
MecaSoft: 4taniakonanevich@tut.by
mediacube: info@mediacube.network
MEG Analytics: info@meg-analytics.com
Megarost Group: admin@megarost.by
MegaSOFT: pepsikola@bk.ru
METAGILE: metagile@gmail.com
Metatag Digital: hello@metatag.by
Mifort: hr@mifort.org
Millcom: info@millcom.by
Mitrix Technology: info@mitrix.io
Molimo: timur.tazhbayev@gmail.com
monostack: oleg.romeyko@gmail.com
Mraid.io: alex@mraid.io
Mühlemann &amp; Popp Online Media AG: marina.krishkevich@muehlemann-popp.ch
Myagi: dev@myagi.com
MyNetDiary Inc: drachev@mynetdiary.com
NaStarte.by: top@nastarte.by
NeatTech: nastassia@neattech.io
Netcracker: HumanResourceMinskGroup@netcracker.com
Next Network: info@nextnetwork.by
Nezaboodka Software: contact@nezaboodka.com
Nineseven: nine@nineseven.ru
Nitka Technologies: igor.romanov@nitka.com
Nord-Soft: contact@nord-soft.com
Novacom: info@novacom.by
NSITE STUDIO: box@nsite.by
Ocean Development: alex@oceandev.io
OCSICO: HR@ocsico.com
Offsiteteam: hr@offsiteteam.com
Olimpia: webolimpia@gmail.com
OMERTEX: contact@omertex.com
Omicron Soft: info@omicronsoftcompany.com
On The Spot Development: elena.savchak@onthespotdev.com
Onilab: talkto@onilab.com
Onix: info@onix.by
OOO "ЮВР": si@uvr.su
OOO NORTH IT GROUP: viktoriya.harlan@northitgroup.com
Orangesoft: hr@orangesoft.by
Orion Soft: info@orionsoft.net
Ormedia: info@ormedia.by
outstaffing.me: contact@outstaffing.me
Oxagile: pr@oxagile.com
OZiTAG: v.ozierski@ozitag.com
Palessit: alexi@palessit.com
PandaDoc: hr-minsk@pandadoc.com
Paprikash.Works: pw3695035@gmail.com
ParaBox: kazbek@parabox.by
Paralect: career@paralect.com
Paspalum: info@paspalum.by
Pax: job.magento@gmail.com
Pay-Me: t.tsimbarevich@ssp-soft.by
Payever: minsk@getpayever.com
PHPDev: info@phpdev.org
Piplos Media: info@piplos.by
Pix Media: info@pix.by
PixelPlex: info@pixelplex.by
PJ Software: info@pj-software.com
Postindustria: eugene.ivanou@postindustria.com
PRAS: list@pras.by
Productive Edge, LLC: pe-minsk@productiveedge.com
Profitero: jobs@profitero.com
ProgzIT: info@progz.ru
Propellers: drozdov.a@propeller.by
ProSites: info@prosites.by
ProteiQ: a.strizhenok@proteiq.com
PSA Development Center: hr@psa-software.com
PST Labs LLC: info@pstlabs.by
Pure: irina@pure.dating
Qulix Systems: jobs@qulix.com
Railsware: contact@railsware.com
RaiseTech: contact@raisetech.net
Razam Group: marketing@razam.bz
Red Graphic Interactive Agency: info@redgraphic.com
Red Technologies: info@redtechit.com
RedFox (ООО "Ред Групп": info@redfox.by
Redline: info@redline.by
REDNAVIS: info@rednavis.com
RedStream: info@redstream.by
REID Consulting: info@realizeideas.net
Revoltech LLC: office@revoltechgroup.com
Revotech: v.zhdanovich@revotechs.com
RINGL Technologies: business@ringl.by
RiseArrow: info@risearrow.com
Rocky Media: sales@rocky.by
Rovensys: info@rovensys.by
RozumSoft: info@rozumsoft.by
RozumSystems: y.sidorevich@rozumsoft.by
RT PROJECTS: gleb@razortheory.com
Rubyroid Labs: hello@rubyroidlabs.com
Runa Systems: info@runasystems.com
Ryxol Solutions: i.hryhorchyk@ryxol.com
SaM Solutions: hr@sam-solutions.by
SASecurity Group: info@sasecurity.by
Satellite Innovations, Inc.: eugenia@satelliteinnovations.com
SCAND: info@scand.com
SchoolBook: aleksei.cherkes@gmail.com
ScienceSoft: job@scnsoft.com
Scorum: hr@scorum.com
Sellwin System: info@sellwin-system.by
Semantica-IT: info@semantica.ru
SENLA: sales@senlainc.com
Sensor Tower: recruiting@sensortower.com
Seodev: info@seodev.by
SEOTAG: job@seotag.by
Severex: a.danchenko@severex.io
Sharekey: careers@sharekey.com
Sheep Apps: hello@sheep-apps.com
ShopTo.By: info@shopto.by
Sideways 6: nikita.kudin@sideways6.com
siera technolodji: info@siera.by
Signals Lab: info@signals.by
Simple Solutions: info@simple.solutions
Singulart: hr@singulart.io
Sirion Soft: sales@sirion-soft.com
SITECH: n.pliskovskaya@sitech.by
SiteFactory: shedy@inbox.ru
SivinTech Group: lubachkin.dzmitry@gmail.com
SKDO Systems: hello@skdo.systems
Skywind Group: hr.by@skywindgroup.com
SLAM: info@slam.by
SLSgroup: v.bondarev@transinfo.by
Smart IT: hr@smart-it.io
SmartApp: mail@smartapptech.net
SmartDesign: office@smartdesign.by
SmartexLab: hr@smartexlab.com
Smartym Pro: hr@smartym.pro
Social Discovery Ventures: n.kolodinskaya@sdventures.com
Soft4Brokers: r@s4b.ee
Softacom: hr@softacom.com
SoftClub: resume@softclub.by
Softeq Development: hr@softeq.by
Softgreat: anastasia@softgreat.com
SoftMatrix: info@soft-matrix.com
SoftonWay: p.lychkovskiy@softonway.by
SoftTeco: info@softteco.com
Solarwinds: MinskJobs@solarwinds.com
SolbegSoft: job@solbeg.com
Solid Expert: info@solidexpert.ltd
Solvd, Inc.: lkuhareva@solvd.com
SolveIt: hr@solveit.by
SONETICO: info@sonetico.com
SpaceDog: info@spacedog.by
Sparkler Soft: sparklersoft@gmail.com
Specific-Group: job.by@specific-group.com
SpiralScout: olga.chadovich@spiralscout.com
SpringWeb: manager@springweb.by
Spritecs: info@spritecs.com
SQILSOFT: info@sqil.by
Staarter: irina.sainuk@staarter.com
STACKLEVEL: office@stacklevel.org
Starcostudio: info@starcostudio.com
Start Matter: contact@startmatter.com
Straut &amp; Skobelev: connect@straut-skobelev.com
StyleSoft: info@stylesoft.by
Success Craft: career.successcraft@gmail.com
SumatoSoft: resume@sumatosoft.com
SVAPS Systems: hr@svaps.com
SWD: info@swd.studio
SWS: krubis88@gmail.com
Syberry: job@syberry.com
SymfonyArt: contact@symfonyart.com
Synesis sport: hr@synesis-sport.by
Tanix Group: info@tanix.by
Tapston: a.khanenya@tapston.com
Taqtile: sergei.fedorenko@taqtile.com
TargSoft: info@targsoftware.com
TechMedia: manager@techmedia.by
Techvice LLC: contact@techvice.org
Tectus Media: ivan@tectus.by
Telesphor Software: hr@telesphorus.by
Teqniksoft: hr@teqniksoft.com
TerraScale LLC: valentin.monosov@adshare.tv
Texode Technologies: hr@texode.com
The Landing Page: info@thelandingpage.by
ThinkPay: hr@thinkpay.by
Timvero: hello@timvero.com
Toptal: dmitry@toptal.com
TouchSoft: vpodmasko@touchsoft.by
Track-POD: info@track-pod.com
Trakhtenberg Consulting Agency: hr@tca.by
TravelLine: Elena.mikhailik@travelline.by
TravelSoft: info@travelsoft.by
TravoLab: info@travo-lab.com
TRexSoft: info@t-rex.by
Turbomates Soft: info@turbomates.com
TUT.BY / HOSTER.BY: info@relsoft.by
Twistellar: hello@twistellar.com
Unicoding: info@unicoding.by
UNIQ Digital: info@uniq.by
UPH Global: hello@uph-digital.com
Upsilon-It: slava.ignatenko@upsilonit.com
US Belar IT Group: dmalyshko@usbelar.com
UserExperience: info@uex.by
UXpresso: uxpresso@uxpresso.by
Velmie: hello@velmie.com
VelvetDEV: alex@velvet.by
Vertic: vlad.khitrik@vertic.com.au
VG Group: Info@vg-group.pro
VIAcode: Oleg.Yeroshevich@viacode.com
Viber: marina@viber.com
Vigbo: hello@vigbo.com
VironIT: cv@vironit.com
Vivim: info@vivim.net
Vladimir Kozlovsky Lab: welcome@kozlovskylab.com
Voloshin IT Agency: kristina.k@voloshin.by
VRP Consulting: hr@vrpconsulting.com
vServices LTD: info@vservices.com
Waste Logics Software Limited: hr@wastelogics.com
WaveOC Pte Ltd.: hr@waveoc.com
Weavora: ask@everhour.com
Web Focus: info@webfocus.by
Web VIKI: hr@webviki.by
Web-agent.by: mail@web-agent.by
Web-design Studio Company HoD: info@it-hod.com
WebAtom: info@webatom.by
Webbox: webboxby@gmail.com
WebBuild: htmlcenter.by@gmail.com
WebCat: info@webcat.by
WebileSoft: info@webilesoft.com
WebMatrix: info@webmatrix.by
WebNewUp: info@webnewup.by
WEBPAY (ООО "ВЕБ ПЭЙ"): office@webpay.by
WebProfi.me: info@webprofi.me
WebRocco: hr@webresolve.org
WebSfera: dir@websfera.by
Wedextim: info@wedextim.by
Wellnuts creative group: info@wellnuts.by
WERBDESIGN: info@werbdesign.com
Wisercat Software: elena.shilova@wisercat.eu
Wizart: ekaterina.smirnova@wizart.tech
WM Reply: info@wmreply.by
WordPress development agency "Seattleby": maksim@seattle.by
WoxLink Development: marketing@woxlink.company
WSP-Design: wspdesign@gmail.com
XB Software: hr.managers@xbsoftware.com
Xmark: info@xmark.dev
XPGraph: contact@xpgraph.com
XPRIDE: info@xpride.by
YayFon Technologies: business@yayfon.com
Yellow: hi@yellow.systems
Yopolis Lab, LLC: elagonenko@yopolis.ru
Z-Wolves Development: hr@zwolves.com
Zensoft: jobs@zensoft.by
Zifferblatt: zifferblatt.by@gmail.com
Zorachka*: hr@zorachka.com
ZubrSoft: info@zubrsoft.com
Агентство Интернет Технологий: reg@agit.by
Агентство комплексных решений "CHROME": evgenii@chr.by
Азбука управления: info@8ka.by
Алавир: info@alavir.by
АлюсофтБел: job@alusoft.by
Анталоджик: info@antalogic.com
Ариол Медиа: info@ariol.by
АртВэбБай: rover@artofweb.ru
Байт протект: contact@byte-protect.com
Белинфопортал: info@belinfoportal.by
БЕЛСМАРТ СИСТЕМЫ: info@belsmart.by
Букмекерская компания Maxline: pavel@maxline.by
Веб Студия Tomson: xeniatomson@yandex.ru
Веб-студия "Edulab": info@edulab.by
Веб-студия "Пингвин": info@penguin.by
Веб-студия IToblaka: 1sale@itoblaka.by
Веб-студия VMN.BY: info@vmn.by
Веб-студия Wecan: mb@wecan.by
Веб-студия ВЭБЛАБ: info@wlab.by
Визент Медиа: contact@wisent-media.by
Виртуальный свет: info@virtuallight.by
ВОТЕ ОХО: office@omut.biz
ВОТКЛИК: votclick@gmail.com
Гиперлинк, интернет-агентство: info@giperlink.by
Глобал Диджитал Консалтинг: post@icoda.io
ГородИнфо: web@gorodinfo.by
Джей лаб: idea@jl.by
Джет ФОРС: postmaster@jet-fors.ru
Дизайн-бюро 2Geart: sm@2geart.com
Единый Кошелек: by@walletone.com
Иквадарт: info@iquadart.by
ИМПА: impalab@gmail.com
Инавеб: service@inaweb.by
Индивидуальный предприниматель Курманов Иван Вячеславович: duraley@gmail.com
Индивидуальный предприниматель Мельников Роман Валерьевич: roman_melnikov@tut.by
Интернет Рынок: 5616161@tut.by
ИП Андрей Кудрицкий: akudrytski@gmail.com
ИП Гайдук Дмитрий Александрович: dementeyyy@gmail.com
ИП Ремша Д.М.: hr@remsha.com
ИП Терновский Артем Александрович: artsiom.tsernouski@sitewerk.ch
ИП Филипович В.В.: vvf@cardone.by
ИП Хотянович А.В.: alexhotianovich@gmail.com
ИП Чалевич Н.В.: youarewelcome.it@gmail.com
ИП,Горский А.Ю,: info@seoexpert.by
ИУП "1С-Битрикс": Belarus@1c-bitrix.by
КАМО АйТи: hr@camo-it.com.by
Карголинк: g.petrovsky@cargolink.ru
КасперСистемс: sp@kasper.by
Креатек: waitresume@gmail.com
Креатив-Лаборатория 82: 2392711@KL82.com
Креативная Студия Кукушка: info.kukushka@mail.ru
Лаборатория информационных технологий: general@i-mogilev.club
Лайкит: info@likeit.by
Лайм Медиа: INFO@LMEDIA.BY
Лендинг Пейджес: info@landingpages.by
Лингвистический софт: editor@language101.com
Майхип: contact@migheap.com
МАПСОФТ: marketing@mapsoft.by
Масштабные решения: mr@mrsoft.by
МегаСайтГрупп: megasaitgrupp@yandex.ru
МигСофт: info@migsoft.by
Настоящие Технологии ООО: info@truetech.by
Наш Белый Дом: info@nbd.by
НВП Модем: office@modem.by
НЕКЛО: info@neklo.com
НКА: nca@nca.by
Огромная черепаха: info@hugeturtle.com
ООО "АДМсолюшн": info@admport.by
ООО "АпГруп": info@upgroup.by
ООО "Байкард": info@bycard.by
ООО "Бюро технологических решений": ss@techburo.by
ООО "ВайФай Мэп": olga@wifimap.io
ООО "ВебФокс": webfox@webfox.by
ООО "ВКС Технологии и системы": office@vksgroup.by
ООО "ВсетиБай": alenashavel@yandex.ru
ООО "ГУДДИЛ": mail@goodmedia.biz
ООО "ИнфоИдея": info@infoidea.by
ООО "ИтерТех Инновэйшенс": office@itertech.by
ООО "Лэмплайтер": a.isachenko@lamplighter.dev
ООО "Тиспр": marya.kruhlikava@tispr.com
ООО "Энвижен" (neoviso™): grigory@neoviso.com
ООО «АскерВЕБ»: hr@askerweb.ru
ООО «СофтЛид»: hr@weblid.biz
ООО «ЭлитСофт»: info@elitesoft.by
ООО ITT Communications: boris.lipkind@itt-us.com
ООО БелТрасБилет: hr@beltransbilet.by
ООО Инфотехнологии: ksyomushkina@minsk.ximxim.com
ООО ИТР Софт: am@itr.com.by
ООО СНМТ Технолоджис: contact@sunmait.com
ООО Хаски медиа: hello@huskymedia.by
ОТР: Babienko.vyacheslav@otr.ru
Первая Линия: alvd7@yandex.ru
ПКБ «Витебск»: 16@pkbasu.by
Поток Проектов: sales@doctype.by
Представительство PamConsult Gmbh в Минске: contact@pamconsult.by
Прогрессив Софт: info@v-sage.by
СайтФутур: manager@1st-studio.by
Свой Сайт: info@svoisite.by
Связьинвест: root@si.by
Сеоклик/SeoClick: info@seoclick.by
Сеотим Медиа / SEOTEAM: info@seoteam.by
Сервис Ай-Ти: info@servit.by
Системы для бизнеса: info@1sys.by
Смартпро: info@smartpro.by
Создание сайтов ALIVA: info@aliva.by
Софтмакс системы телеметрии: info@softmax.by
Спортдата: info@sportdata.by
Старонка: hello@staronka.by
Студия Борового: info@db.by
Студия веб-дизайна DreamTeam: info@dteam.by
Студия Райт: all@right.by
Территория АйТи: info@it-territory.by
Технологии Успеха: forum@tu.by
ТКП-Софт: i.aniskevich@tcp-soft.com
ТКсэт: m.golubeva@tcset.ru
тотл центр групп: nionila@innotech-labs.com
Фабрика брендов: info@fabrikabrendov.by
ФП Трэйд: hr@fptrade.by
Хэпикс: info@happix.by
Центр банковских технологий: cbt@cbt.by
Центр Интернет маркетинга: job@cim.by
Центр инфо технологий: acsidian@gmail.com
Центр Прогрессивных Разработок: alexandra.prus.velox@gmail.com
Цифровое агентство ВИДЖЕТСОФТ: info@widgetsoft.pro
Эйво: info@avo.by
Экстмедиа: info@extmedia.com
ЭмпатиБай: info@empathy.by
ЭнкиСофт: hr@enkisoft.by
ЭстерСтар: inbox@ester.co
